3CE → 3CE
3M → 3M
ABIB → 아비브
ABK → ABK
ABOUT TON → 어바웃톤
ABOUT TONE → 어바웃톤
ACNES → 아크네스
AGE 20's → 에이지투웨니스
AHC → AHC
AMPLE → 앰플엔
ANUA → 아누아
ATOPAM → 아토팜
AVENE → 아벤느
AXIS-Y → AXIS-Y
BANILA CO → 바닐라코
BILLYF → 빌리프
BIODERMA → 바이오더마
BIOFEM → 바이오펨
BLISTEX → 블리스텍스
BOHO → BOHO
BRINGGREEN → 브링그린
BRONDI → 블랑디바
BY REAL BARRIER → 리얼베리어
CANMAKE → 캔메이크
CARMEX → 카멕스
CELLIMAX → 셀리맥스
CKD → CKD
CLIO → 클리오
COSNORI → 코스노리
COSRX → 코스알엑스
DAILYCOMMA → 데일리콤마
DALBA → 달바
DASHU → 다슈
DEARCLAIRS → 디어클레어스
DONGKUK PHARMACEUTICAL → 동국제약
DR.G → 닥터지
DUETREE → 듀이트리
EGF올로지 → EGF올로지
ESPOIR → 에스쁘아
ESTRA → 에스트라
ETUDE → 에뛰드
EUCERIN → 유세린
EZDERM → 이지덤
FORENCOS → 포렌코즈
GAHI → 가히
GIVERNY → 지베르니
GLINT → 글린트
GROWERS → 그로워스
HANSKIN → 한스킨
HERA → 헤라
HINDS → 힌스
HOLIKA HOLIKA → 홀리카홀리카
ILLIYUN → 일리윤
innisfree → 이니스프리
IOPE → 아이오페
IZANROKS → 이자녹스
LAKA → 라카
LANEIGE → 라네즈
LAROCHE-POSAY → 라로슈포제
LBB → LBB
LG생활건강 → LG생활건강
LILLYBYRED → 릴리바이레드
LUNA → 루나
MACQUEENNYC → 맥퀸
MADECA21 → 마데카21
MAKEHEAL → 메이크힐
MAKEPREM → 메이크프렘
MAMONDE → 마몽드
MEDICUBE → 메디큐브
MEDIFIL → 메디필
MEDIHEAL → 메디힐
MERZY → 머지
MILK TOUCH → 밀크터치
MILKTUCH → 밀크터치
MISHA → 미샤
MISSHA → 미샤
NAD → NAD
NDP → NDP
OFRA → 오프라 코스메틱
OOTD → OOTD
PANELL → 파넬
PARTYON → 파티온
PERIPERA → 페리페라
PHYSIOGEL → 피지오겔
PLAY101 → 플레이101
PRILUDE DINT → 프릴루드딘트
PRIMERA → 프리메라
RISKEY → 리스키
RMK → RMK
ROMAND → 롬앤
rom&nd → 롬앤
ROUND LAB → 라운드랩
SKINFOOD → 스킨푸드
SNP → SNP
SOMISOM → 소미솜
SPUUN → SPUUN
SVR → SVR
TAG → 태그
THE ORDINARY → 디오디너리
TITAD → 티타드
TONYMOLY → 토니모리
TORIDEN → 토리든
TORRIDEN → 토리든
UNKNOWN → 기타
URBAN DECAY → 어반디케이
VASELINE → 바세린
VDL → VDL
VT → VT
WAKE MAKE → 웨이크메이크
YNM → YNM
Dr.Jart+ → 닥터자르트
Dr Jart → 닥터자르트
d'Alba → 달바